###################
#.................#
#......####.......#
#.................#
#.................#
#.................#
####..............#
#..#..............#
#.................#
#..#..............#
####..............#
#...........#..#..#
#.................#
#...........#..#..#
#.................#
###################
